R 1500 700
NO ./xpm/computer2.xpm
SO ./xpm/computer1_1.xpm
WE ./xpm/computer_profile3.xpm
EA ./xpm/computer_profile3.xpm
S ./xpm/dye_powder_cyan.xpm
F 200,230,225
C 120,120,255

S1 ./xpm/angry_man.xpm
SA ./xpm/back_man.xpm
P0 ./xpm/cat1.xpm
P1 ./xpm/cat1.xpm
P2 ./xpm/cat1.xpm
P3 ./xpm/cat1.xpm
P4 ./xpm/cat2.xpm
DN ./xpm/door_wood.xpm
DS ./xpm/door_otherside.xpm
DE ./xpm/door_wood.xpm
DW ./xpm/door_otherside.xpm

111111111111111111111111111111111
111111111111111DD1111111111111111
100000000000000000000000000000001
111111111111111001111111111111111
100000000000000000000000000000001
111111111111111001111111111111111
100000000000000000000000000000001
111111111111111001111111111111111
100000000030000000000000000000001
111111111111111001111111111111111
100000000000000000000000000000001
111111111111111001111111111111111
100000000000000000000000200000001
111111111111111001111111111111111
100000000000000000000000000000001
111111111111111001111111111111111
100000000000000000000000000000001
111111111111111001111111111111111
100000000000000000000000000000001
111111111111111001111111111111111
100000000000000000000000000000001
111111111111111001111111111111111
100000000200000000000000000000001
111111111111111001111111111111111
100000000000000000000000000000001
111111111111111001111111111111111
100000000000000000000000000000001
111111111111110N01111111111111111
111111111111111DD1111111111111111
111111111111111111111111111111111