R 1500 700
NO ./xpm/computer2.xpm
SO ./xpm/computer1_1.xpm
WE ./xpm/computer_profile3.xpm
EA ./xpm/computer_profile3.xpm
S ./xpm/dye_powder_cyan.xpm
F 200,230,225
C 120,120,255

S1 ./xpm/angry_man.xpm
SA ./xpm/back_man.xpm
P0 ./xpm/cat1.xpm
P1 ./xpm/cat1.xpm
P2 ./xpm/cat1.xpm
P3 ./xpm/cat1.xpm
P4 ./xpm/cat2.xpm
DN ./xpm/door_wood.xpm
DS ./xpm/door_otherside.xpm
DE ./xpm/door_wood.xpm
DW ./xpm/door_otherside.xpm
LI ./xpm/heart.xpm
PO ./xpm/play_again_button.xpm
WI ./xpm/You-Win.xpm

1111111111111111111111111111111111
1111111111111111D11111111111111111
1D000000000000000000000000000000D1
1111111111111111011111111111111111
1D000000000300000000000000000000D1
1111111111111111011111111111111111
1D000000000000000000000000000000D1
1111111111111111011111111111111111
1D000000000000000000000020000000D1
1111111111111111011111111111111111
1D000000000000000000000000000000D1
1111111111111111011111111111111111
1D000000000000000000000000000000D1
1111111111111111011111111111111111
1D000000000000000000000000000000D1
1111111111111111011111111111111111
1D000000000000000000000000000000D1
1111111111111111011111111111111111
1D000000002000000000000000000000D1
1111111111111111011111111111111111
1D000000000000000000000000000000D1
1111111111111111011111111111111111
1D00000000000000N000000000000000D1
1111111111111111D11111111111111111
1111111111111111111111111111111111