R 1500 700
NO ./xpm/planks_oak.xpm
SO ./xpm/planks_oak.xpm
WE ./xpm/bookshelf.xpm
EA ./xpm/bookshelf.xpm
S ./xpm/spider_eye.xpm
F 200,230,225
C 120,120,255

S1 ./xpm/dye_powder_cyan.xpm
SA ./xpm/spider_eye_fermented.xpm
P0 ./xpm/bow_pulling_0.xpm
P1 ./xpm/bow_pulling_1.xpm
P2 ./xpm/bow_pulling_2.xpm
P3 ./xpm/bow_standby.xpm
P4 ./xpm/bow_pull_3.xpm
D ./xpm/door_iron.xpm



        1111111111111111111111111
        1000000000110000000000001
        1011000001110300002000001
        1001000000000000000000001
111111111011000001110000000000001
100030000011000001110111111111111
11110111111111010000000010001
111101D1111111011101010000001
11000000110101011100000010201
10002000000000001100000010001
10000000000000001101010010001
1100000111010101111101111000111
11110111 1110101 101111010N01
11111111 1111111 111111111111


