R 1500 700
NO ./xpm/42_game/computer_NO.xpm
SO ./xpm/42_game/computer_SO.xpm
WE ./xpm/42_game/glass_silver.xpm
EA ./xpm/42_game/glass_silver.xpm
S ./xpm/dye_powder_cyan.xpm
F 200,230,225
C 120,120,255

SF ./xpm/42_game/angry_man.xpm
SD ./xpm/42_game/back_man.xpm
W0 ./xpm/42_game/norminet_released.xpm
W1 ./xpm/42_game/norminet_released.xpm
W2 ./xpm/42_game/norminet_released.xpm
W3 ./xpm/42_game/norminet_catched.xpm
DN ./xpm/door/door_wood.xpm
DS ./xpm/door/door_otherside.xpm
DE ./xpm/door/door_wood.xpm
DW ./xpm/door/door_otherside.xpm
LI ./xpm/heart.xpm
LO ./xpm/replay_button.xpm
WI ./xpm/win_game.xpm

1111111111111111111111111111111111
1111111111111111D11111111111111111
111111111111111D3D1111111111111111
1111111111111111D11111111111111111
1000000000000000000000000000000001
1111111111111111001111111111111111
1000000000030000000000000000000001
1111111111111111001111111111111111
1000000000000000000000000000000001
1111111111111111301111111111111111
1000000000000000000000002000000001
1111111111111111001111111111111111
1000000000000000000000000000000001
1111111111111111001111111111111111
1000003000000000030000000000000001
1111111111111111001111111111111111
1000000000000000000000000000000001
1111111111111111001111111111111111
1000000000000000000000000000000001
1111111111111111001111111111111111
1000000000200000000000000000000001
1111111111111111001111111111111111
1000000000000000000000000000000001
1111111111111111001111111111111111
1000000000000000N00000000000000001
1111111111111111D11111111111111111
1111111111111111111111111111111111