R 1920 1080
NO ./xpm/basic/the_north_texture.xpm
SO ./xpm/basic/the_south_texture.xpm
WE ./xpm/basic/the_west_texture.xpm
EA ./xpm/basic/the_east_texture.xpm

S ./xpm/basic/the_sprite_texture.xpm
F 220,100,0
C 225,30,0

1111
1001
1111
  
      1
        1111111111111111111111111
        1000000000110000000000001111
        1011000001110000002000001
        1001000000000000000000001
111111111011000001110000000000001
100000000011000001110111111111111
11110111111111011100000010001             1111111111
11110111111111011101010010001             1222S22221
11000000110101011100000012001             1222222221
100020000000000011022000000011            1222222221
10000000000000001101010010001             1111111111
1100000111010101111101111000111
11110111 1110101 101111010001
11111111 1111111 111111111111
   11
   1
1
