R 150000 700000
NO ./xpm/winter_game/snow.xpm
SO ./xpm/winter_game/glass.xpm
WE ./xpm/winter_game/ice_1.xpm
EA ./xpm/winter_game/grass_side_snowed.xpm
S ./xpm/winter_game/Olaf_resize.xpm
F 199,220,227
C 149,226,250


   11111111111111111111111111
11120000000000000000000000001
 1100000000000000000000000001
11100111111111111111111111001
 11001     1111111111111110011111111111
111001     10000000001   1001 100020001
 11001     10000000001   1001 100000001
111001111  10011111001   1001 100200201
 11000021  10011000001   1001 100000001
111001111  10011000001   1001 10000N001
 11001     10011000001   1001 100000001
111001     100111111111111001 111100111
 11001     100000000000000001   110011
111001     100000000000000021    10011
 1100111111111111111111111111111110011
11100000000000000000000000000000000011
 1120000000000000000000000000000000211
11111111111111111111111111111111111111
